HHHHHHHHHHHHHHHH
H      H       H
H      H   H   H
       H   H   H
HHHHHH HH HHH  H
H   H  H   H   H
H   H      H   H
H   HHHHHHHHH HH
H              H
HHHHHHHHHHHHHHHH
================