HHHHHHHHHHHHHHH
H          H  H
H          H  H
           H  H
HHHHHH HHHHHHHH
    H  H H H
    H  H  H
    H  HHHH   H
    H         H
    HHHHHHHHHHHHH