HHHHHHHHHHHHHHHH
H        H     H
H        H     H
H   H    H  H  H
H   H aaaH  H  H
H   H aAaH  H  H
H   H aaa   H  H
H   HHHHHHHHH  H
H              H
HHHHHHH00HHHHHHH