HHHHHHHHHHHHHHHH
H              H
H              H
H  HHHHHHHHHH  H
5  H        H  6
5  H        H  6
H  HHHHHHHHHH  H
H              H
H              H
HHHHHHHHHHHHHHHH