HHHHHHHHHHHHHHHH
H              H
H              H
H              H
G              H
H   HHH  HHH   H
H   H      H   H
H   HHHHHHHHH HH
H              H
HHHHHHHHHHHHHHHH
