HHHHHHHHHHHHHHHH
H              H
H              H
H              H
7              H
7              H
H              H
H              H
H              H
HHHHHHH88HHHHHHH