HHHHHHHHHHHHHHHH
H              H
H              G
H              G
H              H
H   HHH  HHH   H
H   H      H   H
H   HHHHHHHHH HH
H              H
HHHHHHHHHHHHHHHH
