HHHHHHH99HHHHHHH
H              H
H              H
H              H
H              H
H              H
Hfff           H
HfFf           H
Hfff           H
HHHHHHHHHHHHHHHH