HHHHHHHHHHHHHHHH
H           eeeH
H           eEeH
H     HHHH  eeeH
7     H        H
7     H        H
H     H  H     H
H     H  H     H
H     H  H     H
HHHHHHH88HHHHHHH