HHHHHHHHHHHHHHHH
H QQQ  H       H
F QAQ  H   H   H
F QQQ  H   H   H
HHHHHH HH HHH  H
H   H  H   H   H
H   H      H   H
H   HHHHHHHHH HH
H              H
HHHHHHHHHHHHHHHH
