HHHHHHH11HHHHHHH
H              H
H              H
H  HHHHHHHHHHHHH
H  H           H
H  H   H  bbb  H
H  H   H  bBb  H
H      H  bbb  2
H      H       2
HHHHHHHHHHHHHHHH