HHHHHHHHHHHHHHHH
H      H       H
F      H   H   H
F      H   H   H
HHHHHH HH HHH  H
H   H  H   H   H
H   H      H   H
H   HHHHHHHHH HH
H              H
HHHHHHHHHHHHHHHH
